NO ./assets/textures/temple_textures/example.xpm
SO ./assets/textures/temple_textures/example.xpm
WE ./assets/textures/temple_textures/example.xpm
EA ./assets/textures/temple_textures/example.xpm

F 64,64,64
C 0,40,40

1111111111
1000000001
1000000001
1000000001
1000000001
1012121101
1000002001
1000001001
1000N00001
1111110111
     121
     121
     121
     121
     121
     111