NO ./assets/textures/temple_textures/example.xpm
SO ./assets/textures/temple_textures/example.xpm
WE ./assets/textures/temple_textures/example.xpm
EA ./assets/textures/temple_textures/example.xpm

F 64,64,64
C 0,40,40

1111111111
1000000001
1000000001
1000000001
1000000001
10121211011
1000002001
10000010011
1000N000011
1111110111
     121
     121
     121
     121
     121
     111