NO ./assets/textures/temple_textures/example.xpm
SO ./assets/textures/temple_textures/example.xpm
WE ./assets/textures/temple_textures/example.xpm
EA ./assets/textures/temple_textures/example.xpm

F 64,64,64
C 0,40,40

1111111111111111
10011100020002 1
1001 10001000111
1001110001000001
1000000001111111
1012121101
1100002001
1000001001
1000N00001
1111111111