NO ./map_files/temple_textures/temple1.xpm
SO ./map_files/temple_textures/temple2.xpm
WE ./map_files/temple_textures/temple3.xpm
EA ./map_files/temple_textures/temple4.xpm

F 40,40,40
C 0,40,40

11111
100E1
11111