NO ./map_files/example.xpm
SO ./map_files/example.xpm
WE ./map_files/example.xpm
EA ./map_files/example.xpm

F 64,64,64
C 0,40,40

1111111111
1000000001
1000000001
1000000001
1000000001
1111111101
1000000001
1000000001
1000N00001
1111111111