NO ./assets/textures/temple_textures/example.xpm
SO ./assets/textures/temple_textures/example.xpm
WE ./assets/textures/temple_textures/example.xpm
EA ./assets/textures/temple_textures/example.xpm

F 64,64,64
C 0,40,40

1111111111111111
1000000002000201
1000000001000111
10000000010001 1
1000000001111111
1012121101
1100002001
1000001001
1000N00001
1111111111