NO ./assets/textures/temple_textures/example.xpm
SO ./assets/textures/temple_textures/example.xpm
WE ./assets/textures/temple_textures/example.xpm
EA ./assets/textures/temple_textures/example.xpm

F 50,50,40
C 90,90,80

1111111111
1000000001
1000000001
1000000001
1000000001
111212111111111111111111111111111111
100000000000000000001000000000000001
100000000000000000001000000000000001
112111111111111111111111111111100001
100000000000000000000000000000000001
100000000000000000000000000000000001
111111111111121111111111111111111111
100100010001000100010010000000000001
100001000100010001000010000010000001
100100010001000100010010000011121111
100000000000000000000010000010000001
100100010001000100010010000010000001
100000000000000000000010000010000001
111211111111111111111110000010000001
100000000000000000000000000010000001
10000000000000000000000000001000E001
111111111111111111111111111111111111