NO ./assets/textures/ww2_textures/gw310.xpm
SO ./assets/textures/ww2_textures/gw410.xpm
WE ./assets/textures/ww2_textures/gw510.xpm
EA ./assets/textures/ww2_textures/gw610.xpm

F 64,64,64
C 0,40,40

        1111111111111111111111111
        1000000000110000000000001
        1011000001110000000000001
        1001000000000000000000001
111111111011000001110000000000001
100000000011000001110111111111111
11110111111111011100000010001
11110111111111011101210010001
11000000110101011100000010001
10000000000000001100000000001
10000000000000001101010012121
1100000111012101111101111000111
11110111 1110101 101111010N01
11111111 1111111 111111111111